AFG = "countries/Afghanistan.txt"
AZU = "countries/Aizu.txt"
ABA = "countries/Albania.txt"
AMC = "countries/America.txt"
ARB = "countries/Arabia.txt"
AGT = "countries/Argentina.txt"
AUS = "countries/Australia.txt"
BAV = "countries/Bavaria.txt"
BTN = "countries/Britanny.txt"
BUL = "countries/Bulgaria.txt"
BGN = "countries/Bengla.txt"
CAT = "countries/Catalonia.txt"
CAU = "countries/Caucus.txt"
CTM = "countries/CentralAmerica.txt"
CIS = "countries/Cisalpine.txt"
COL = "countries/Colombia.txt"
CRI = "countries/Crimea.txt"
CZA = "countries/Czechia.txt"
DAN = "countries/Danube.txt"
DSR = "countries/Deadsea.txt"
EGD = "countries/England.txt"
FIN = "countries/Finland.txt"
FOR = "countries/Formosa.txt"
FRN = "countries/France.txt"
GMN = "countries/GreaterMongolia.txt"
GRC = "countries/Greece.txt"
GXI = "countries/Guangxi.txt"
GUJ = "countries/Gujarat.txt"
HNW = "countries/Hannover.txt"
HSE = "countries/Hesse.txt"
ITL = "countries/Italy.txt"
JSE = "countries/Joseon.txt"
KRD = "countries/Kurdistan.txt"
LEV = "countries/Levant.txt"
MCD = "countries/Macedonia.txt"
MNS = "countries/Manispahit.txt"
MXC = "countries/Mexico.txt"
MNG = "countries/Mongolia.txt"
MTG = "countries/Montenegro.txt"
NOR = "countries/Norway.txt"
IRN = "countries/Persia.txt"
PEU = "countries/Peru.txt"
POR = "countries/Portugal.txt"
PRS = "countries/Prussia.txt"
PRL = "countries/PrussoRussianLegation.txt"
QNG = "countries/Qing.txt"
QUE = "countries/Quebec.txt"
RHN = "countries/Rhine.txt"
ROM = "countries/Romania.txt"
ROS = "countries/Rostov.txt"
RSL = "countries/Russland.txt"
SNJ = "countries/SanJuan.txt"
SIB = "countries/Siberia.txt"
SLO = "countries/Slovakia.txt"
SBZ = "countries/SocialistBrazil.txt"
SAM = "countries/SouthAmerica.txt"
SPN = "countries/Spain.txt"
SWE = "countries/Sweden.txt"
TRG = "countries/Thuringen.txt"
TRS = "countries/Transamur-Siberia.txt"
TRN = "countries/Transamur.txt"
TRC = "countries/Transcarpathia.txt"
TKK = "countries/Turkestan-Kazakh.txt"
TKT = "countries/Turkestan-Tibet.txt"
TRK = "countries/Turkey.txt"
UKR = "countries/Ukraine.txt"
URU = "countries/Uruguay.txt"
YTZ = "countries/Yangtze.txt"
NTJ = "countries/NusaTanjungnagara.txt"
PPA = "countries/Papua.txt"
SIP = "countries/SwamadwIpa.txt"